NO assets/textures/simonkraft/wet_sponge.xpm
SO assets/textures/simonkraft/wet_sponge.xpm
WE assets/textures/simonkraft/wet_sponge.xpm
EA assets/textures/simonkraft/wet_sponge.xpm



F     1,1         ,              155

C 1,1,1

111111111111111111111111111
111111111110000001001
101010101011111110101
100010100010000010001
111110101111101011101
100000101000101000001
101111101011101111111
101000001010100000101
111111111010111110101111111111
     110101S001010100010101
1111111101000101010101111111111
1000001010100010100011
111111101010011011101
100000101000000010001
101110101100101110111
101000100000100010101
101011111100111010101
100010000000000010001
101010111000111111101
110000001000000000001
111111111111111111111

